##############################
#............................#
#............................#
#............................#
#........###########.........#
#............................#
#.............#..............#
#.............#..............#
#.............#..............#
#.............#..............#
#............................#
#............................#
#............................#
##############################