##############################
#............................#
#............................#
#............................#
#........#.........#.........#
#........#.........#.........#
#........#.........#.........#
#........#.........#.........#
#........#.........#.........#
#........#.........#.........#
#............................#
#............................#
#............................#
##############################