##############################
#............................#
#..............#.............#
#..............#.............#
#..............#.............#
#..............#.............#
#..............#.............#
#..............#.............#
#..............#.............#
#............................#
#............................#
#............................#
#............................#
##############################